#########
#   #####
# $ #####
# $ #####
### ###.#
### @  .#
##   #  #
##   ####
#########
